cell	cell_line
ACTTTCTAATCA	BJ
GAGAGAAAACCT	H1
TACGGCTGTTAT	K562
GACGCGTAAGTG	BJ
GAAAGGACTGCA	BJ
TGACCTGGATAA	H1
ACTCCGTTCACT	BJ
TAGGTAGCGCGC	BJ
CTCTACCCTTCA	BJ
GCCCGTTATCTG	BJ
TTCTCGCCGTAA	BJ
GCATGACATATA	H1
GAAATTTATTAG	BJ
CGTCCACGCTTT	H1
CTCTGTTCGTCG	BJ
GGTCCAAAAGCC	H1
TAAAACTTCATA	BJ
AGAGCCAAGCAC	K562
TATTTCCAATAA	BJ
TTTGCCTGCTGT	BJ
CGTCCTGAGCTT	BJ
TGTGCATGTAAC	BJ
AGCGTATACTAA	H1
CGCTTAATCAGC	BJ
AAATTCAGGCGG	BJ
GACGCTGCCAGG	H1
ACCCTGTATTAC	BJ
CATCTATCAAGG	BJ
GTCAAGCACCGC	H1
AGGGCGTTGTAG	BJ
AAATCGATGAAT	BJ
TTTTCCGCCACC	H1
GGGTTCCTTCTT	K562
TAAACTCCGTCT	BJ
ATAAAGAACATC	BJ
ATGGTTTGTCCA	BJ
GTGCCCTCTTTT	H1
GTCTCGCAGGTT	H1
CGCGCACTCGAT	K562
ACGGCCTCCAAA	BJ
CATGAAAGTTGA	BJ
CATGTCGCCTGA	H1
CTGTACTAGAAG	BJ
ATCTCGTGGTGC	H1
GCACCATCATCA	BJ
CTATCATTAAAT	H1
TGAGGCGATGAC	BJ
ATAAACAGCTGC	BJ
GCCCCGAGTGGT	H1
TTCCTTTCGTGC	BJ
ACGCCCGGTACA	H1
AGTCATCAATTC	BJ
ACTCCTATACCC	BJ
TCTCCGTTCCGC	H1
TCATGAGTTCCG	BJ
AAGTCGATCAAC	BJ
GTATTATTATCT	BJ
CGCACTATCTTC	BJ
TACGAATACCTC	BJ
ACTTGGTTCAAG	H1
CTCACCATACGG	H1
TTCATTGAGCAT	BJ
ATCACGGTCCAC	BJ
CACGATTTTACT	BJ
GCCGTGAAGGTG	K562
GACAAACCCGCA	K562
AGACGAATCTAA	H1
CCGATCATAAGA	K562
TCTCGACGCTTG	H1
AGTTTTAGATTA	K562
CGAGTAAATATC	H1
ATTGCTTTCTGT	BJ
GACGGATGTCAA	GM
GAAGCATAAGCC	BJ
CCTACGGGTCAT	BJ
GATTGGACCATT	BJ
GCCCGATCGTTC	BJ
TAGTAAGGCACT	BJ
CGCGTTTTTATA	BJ
GTCAGATTGCCT	BJ
CACAACCGGTCT	BJ
TCCCCCTCGGCT	H1
AGCTCGATTAAA	H1
TAGTGATTGTTC	H1
TACTCGTTACCT	H1
CGACAGTGAGTC	BJ
GCTGACCGTCTC	H1
TTAACGCCTACC	H1
CGCCACGTCCCT	H1
TGCCGGTTGTTC	H1
TTCTAGGCCCGT	BJ
ATCAACTAGAAT	BJ
GCCCATCCTTCC	BJ
GCAGTATCTCAA	BJ
ATTGACCTTTTC	BJ
GACGTATATGCC	BJ
ATACGACGATTC	K562
CCCGACTCTCTA	BJ
ACCGTTAGTGAC	BJ
CGGCGCTTGCAC	H1
CTCCTAGCCGTA	BJ
GCGTCAAAGCGA	BJ
AGGTGTGTGTCC	BJ
GCAACGCCCGCC	H1
AGTGGATCGCGT	H1
ACAGAGAGGACA	H1
TTCTGGACATGC	H1
GCAGAACGCGGT	BJ
GCTCCTATGATA	K562
ATCCTCTTACAT	BJ
GGCTAAACGTAT	H1
ATTTCGCACGTT	H1
GGTATACTGATC	BJ
CGTAACGGATCA	H1
CCGGCATTCTCG	H1
TTGCCTGCATTC	H1
GTGGAGCTGTAA	BJ
GCATTTCGAACC	H1
GCCTTCTGTGGC	BJ
GGACGGTGCGTC	K562
ACGTCATCCGTA	K562
TGATCCGGACTT	BJ
CAGCAGTGAGAA	K562
CCCTTGTCATAA	BJ
AGTCTCCTACTC	H1
CCGGTCACCCGT	H1
CAAAGGGCACTA	H1
AAACCATTCTTC	H1
GTGTTCGTCACC	H1
AAGGCTGGTGAC	BJ
CTTCAAACTCCC	BJ
GCGCCATGTCCC	K562
GGTGGTGAGTAT	BJ
CCCAACATGGAT	K562
CCACGGAGACAA	H1
TTCCTTTCGGTA	BJ
ACTTACCTACCC	H1
CTGAGTCCAACA	H1
GTGAGTCAGCCT	H1
GTGCTTATAGTC	H1
GTGTATTAGGTT	K562
GCTGGCCGTTGA	H1
CCCCCCTGGGCT	H1
AAAACACTCCTG	H1
ACCAGACCCTAT	BJ
CGATCATGGTCC	H1
ACTCATAACTAG	BJ
CTGGATGAGCCC	H1
AGCCTTAGAACA	H1
ACAATACGCGAG	BJ
AACTTGGGACTT	H1
TGGCCGATGGGA	H1
CTCCTTATCCCA	H1
AGCCCCTCACGC	H1
TTCAGTTGTCTT	K562
GGAATGCAGATA	K562
GTGGCCCTCACC	BJ
GGGCTCCACCAT	BJ
GTGATCGCTGGA	BJ
AATGCCAGACTA	BJ
AATGTAGTCTCT	H1
CTTTATCAAAAA	BJ
TACCCCCGTATC	BJ
TCAAGAATTGAA	H1
TCCAGCCAAGGA	H1
CAGCTTCTCGAA	H1
CTGCCAAGACTC	H1
AAACCGGATATC	H1
TGCACTATCCTT	H1
TAGGTAACTAGC	H1
ACCCTAATTTAA	H1
GATGTCACCAAC	BJ
TGGAAAAGGTTT	H1
CGCTATTTGCTA	BJ
TGAGGCGCAACC	H1
GACCCGGACGAG	BJ
AACTAGCCAAAG	BJ
ACGCTTATGACC	K562
CCGACGAAGGTT	H1
CCAAAGTGTACC	H1
GCTCCAGCCGGA	BJ
GTTATATACGAC	BJ
TACCAAAACATT	BJ
AAACATCCCAGC	GM
AACCTTGGTCTC	K562
AATGATTCTGGC	H1
AGCGTGTTTGAA	BJ
AATAAATCTATC	H1
CGAAACGGAGGC	K562
TTCATGCCATGT	H1
TAAGACTGCTAC	BJ
TCGGCCTTTCCC	GM
ACTGCCTATGGA	H1
ATTGGATGTGGT	BJ
GATAGTACCGAA	K562
CGAGGTGTTCGT	K562
GGTCTTTGTGCC	BJ
AAGGTCAGCGGC	K562
GTACCACTTCAC	BJ
GTACTGGGTCCC	BJ
TTGAGTGAACTG	K562
GAATCCTCAGGC	BJ
GGGCGCGATTTC	H1
GTATCGTCGGAT	BJ
AGGAGCCCCCGA	H1
CGACACTTCCCC	K562
ACCAACCTCAGT	K562
GGTTCGGGATAC	BJ
TTGCCCGGGTGA	H1
TATTCGCGGTGT	BJ
GAATTAGGCAAC	H1
GGAGGATACTTA	BJ
CGAATCTTTCAC	H1
GATGTACGCAAA	H1
ACCCTGGAAACC	K562
CCCGACAAAGAA	K562
TACACGGACTAC	GM
CCCGAGCACGCG	H1
AGGGTCCGAATT	K562
TAACACAATTCG	BJ
TGGGATTGACTA	H1
GACTCACCTTGT	K562
TGGCATTCTCCC	H1
CGTTGTTTGAAG	K562
GCGGATCTATTG	H1
CCGGGACATGAT	K562
TGTTCATTTCGT	H1
CACATCATTAAC	BJ
AACGTCCTACTA	BJ
GCAGGCTAGTCA	H1
CTTGCGGCCGCA	K562
ACCCTCGGTTTA	BJ
AGATTACATCGT	BJ
GTGATGCATAGA	BJ
TGCCAACCATCA	H1
ACTGCCTCGATC	BJ
CGCCGCTGAGTT	H1
CGATAGGTCTGT	H1
GTCTGAGTGCAG	H1
GTAGCCGATCAA	H1
AGGCTGATGGAT	BJ
GTACGGTAACCG	K562
TGTACTCCCCCA	H1
CTATTCCTATGA	H1
GTTTTCCGCGTT	K562
TAAATCCTTCAT	H1
ACAAATAACAGT	K562
TCGTGGTTTTTC	BJ
AGGCTTCGTAAC	K562
ATCGGGCAAACG	BJ
CACTCAGCGGCC	H1
GCGACGCCACCA	BJ
TGTGCACTTAAG	BJ
GCGCTCTAAAGA	BJ
GGACCCCGTCAT	H1
CCAAATGCGGAT	BJ
AGTCGTTTTCGA	K562
TGGATGCACAGA	H1
ATAAGCGACGAA	BJ
TCAGCTTCGCCA	H1
AAGGTCCTCAGC	H1
GGCTAATATCCG	K562
CAAGTACGCCCT	BJ
ATTGAGCAGGAT	K562
GACACCTTCAGA	H1
GCGTCCGACGCC	H1
CCCTCCTCGGGC	H1
GTCCAGGATGCC	H1
CGTGGGGTGTTC	GM
CGACAGAAGATG	BJ
GTCGCGTCCGTA	K562
GCCTTCCTGCCC	BJ
AGAGGTAACCTT	BJ
AAAAACGGCCTG	BJ
AGGTGACCACTC	H1
CGTGTCGAGATA	H1
CGTGCTTTCCCA	BJ
TTTGACAGTATG	BJ
AGTCTAAGGTTA	H1
GGCCACTTGCTG	H1
AACCATAGTTAG	H1
ACTCCATAACTT	H1
TTCGTTTCAATC	BJ
TTCTTATGCCCG	BJ
ACTGGGGCTTTA	BJ
TCGTGGATTTCG	BJ
AACATCCCTGAG	BJ
GCGGAAGATAGA	H1
GCGAGCCAAGGG	K562
AACATCCATTCT	K562
CTCAAGGTTGGA	H1
GACACTAGTGCT	H1
CTCATAGGCACA	H1
AAAGTGCCACAT	K562
AGAGAAGGTTCC	BJ
CATCTTAATTAG	H1
GCCTGACGACAA	BJ
AAGGGTGCTAAC	H1
GCGCTGCTGAAA	K562
GTGTGAAACAAA	H1
ACTCTAAAAGGG	BJ
GGGACGCCCTCA	BJ
GTACCATGTGAT	H1
GCCGTACCGCCT	H1
TACACGGCCCGC	H1
ATTCTAACGCCC	GM
CCCACTGTGGGT	H1
GTCACTGGTCGC	H1
CGCTCAGTTCCA	H1
TGTGTTCTGGAG	H1
TCGGATGTTGCC	GM
ATACAGTCGTCA	H1
TAAGCCTCACAC	GM
TACAAGCTGCAG	BJ
GTTTGCATGGTA	K562
AATAGCACTGAA	BJ
TTACAGATCTAT	H1
CGATCCGGCGTA	BJ
AAGGAGAAATGT	GM
CTATTGCTCGTT	H1
GTATGTTATGGT	H1
TAACCTTACGAC	BJ
CCTTGTCCGTTA	K562
AGTAGAATACAA	H1
ACATCTTTGTCC	K562
GGCAATGACCAC	GM
GTAAGATGGCGC	H1
GTAGCTGTGTTC	H1
TGCCTCTGGCCT	BJ
CCGGTAGGCAGC	H1
CTCGACGTGTGA	BJ
AAACCCATGTAC	BJ
CCTAAATATGTC	H1
AAAAGTGTCACG	H1
TTGTGAAACCCG	H1
CGAGTTTATCTC	H1
GCGGTTATGTAG	H1
TGATTAATGGAG	H1
TGTCGCTGCTCC	BJ
GAGATGTCTCTT	H1
TGCACCATATCA	BJ
GATAAGCCGTGA	H1
TGTAGCAACGAG	K562
TTACGGATCGAA	BJ
AGCTAGGTCTCA	BJ
GTACCCTTTGCT	H1
TCGGATCATCGC	H1
CAGTGCCCATCT	BJ
TGCACCGGACTC	BJ
ATCACAGGCACG	GM
TGGGTATCGATG	GM
AAGCCTGATGCC	BJ
GATGCTACCCAA	BJ
GCCGCTGCAGGC	BJ
TGCTGCGCGCAC	H1
TGTGATGGTCGA	BJ
GCAGCCCCGCTG	H1
GGTAAACTACCC	BJ
GGTCACAACCGT	K562
AACTCAGTTATG	H1
GGCTCTCGTGGC	BJ
CTGGAGGCCCAA	H1
ACGAGCTAAGTC	H1
TAGGGGGCGCTC	H1
CAGATTTAGGAA	BJ
ATTGGTCAATTA	BJ
TTTTATTGATCT	K562
TCACAGACTTAG	H1
GCACTTACAGCG	BJ
AACTTACAACAG	GM
ACTTCCATACCT	GM
CGAAGAAACCTC	H1
AAGCTTTCCAAT	BJ
CTGATGCATAAA	H1
AAATACGCCAAG	K562
CTGCAGTACCAG	GM
GGTCATGGTGGT	BJ
GGCACAATCGCG	BJ
AATTCTTGCCAA	GM
GAGATTCTCTAC	GM
TTTCAAGCAACC	GM
GTGCGGACCACA	K562
TCCTACGACCAA	K562
CCCGGGAAGGTA	H1
GGATCAAAATGG	H1
TGGACGCGCTTT	H1
CCAGATCGAAGA	GM
GTCCAAACGCCT	H1
TGGGTACGGCCC	H1
CGCGTGTTCTAT	K562
CGTCAACAGTGT	H1
TAAGAGGGCTAC	BJ
AACCCACGTGGT	GM
CTGGGCTCTTTA	BJ
TAGTTCCGCCTG	H1
GCACACTTCGAA	BJ
TAGTAAATATTG	BJ
TTGACATCTTAA	K562
GTACTGATCCGA	H1
GTGCTGTGTAAG	H1
CTGCCAGAAAAT	BJ
AGATGGGCCGAA	K562
CCATTAGCGACA	H1
GCTACCCCAACA	H1
CGTTCGATTCCG	BJ
GAACCGTCAAAC	BJ
AGATGATCCGGC	BJ
GTCATCGGTCCA	H1
GTTAAAGCGAGG	GM
CGCAGCTATCAT	K562
CTTGAGCACTAG	H1
ACTCTGCCGCGA	H1
ACTTACAGCGTG	K562
TTTACTTTGTGG	K562
CCGCCTCCGGAT	GM
TCAGCGTACTTC	H1
GATCCCTTGGTA	K562
CAAGGCTGAACT	H1
CGATGCCGAGAA	K562
CCACTTAGAGAC	K562
CTTCTAAAGACG	BJ
GAGTCGCTAGGA	H1
AGGAAATTCCCG	H1
AACAAAATGGAA	BJ
TTTGCGGCGTTG	H1
AGATGCAATCCT	K562
GCGATCCGGTGA	H1
GCCCCCAAATAG	H1
CAAGTTAGGTCC	K562
CCACCCATAAGG	BJ
TTAACTGTACAT	H1
CTGCTACATTCA	K562
TGCACCACCACA	H1
GCCCGCTGGGGT	K562
CGTGGAGCTATT	K562
TTCTTCACCTTC	H1
TACTTTGCAGGT	H1
TGTGGAGATTCC	GM
TTTGGTGGTCCA	GM
CGTCTTTTCTGT	H1
CCGGTTCTCGCA	H1
GCGCCCCGCTGC	H1
TAAGTGCGGCAT	GM
GCCGCCGCTATT	H1
GGCAGTCATCCA	K562
CCCTCTACGATT	GM
GGGCGCCCTGAT	K562
GAGGGACAGCCG	K562
CACGCCAACTCT	GM
TTCTACGCAAAG	H1
GTAGCAACGCGG	H1
TCAAATGTTGGC	BJ
CGAGCTGTTATC	H1
AACTGATGGCTA	BJ
GTCGCATAACAG	H1
CAACTTGGAAAT	GM
AACGTACGAACC	BJ
CACTCGGATAAT	BJ
AACAAACGACCA	H1
GCATGTGGGAAA	GM
AAATATGATAGA	H1
CAAGACCGAGAA	BJ
ACTAGCTCGCGT	BJ
CAGTTACGAATG	H1
ACTCCGCCACAA	H1
GCTCATGACCCT	BJ
CGATCCAGATGA	H1
AAAGGACTTAGT	BJ
ATGTAATTTGTC	H1
CGTAGTGTGCGA	H1
GCAACTGTCCCT	H1
CTAGACCCATTT	K562
GGGGCAGGGACT	H1
TGCGGGCAGGAG	BJ
CACTTCCTTGTT	K562
AGCTAACGGGTA	K562
AAGAAGCCACAG	BJ
CAGACTTCTTCG	H1
GCGCTTACATAT	BJ
GTTTCGCTAGGG	H1
ACCGGTAGCTGA	BJ
AAGGTGTCTCCA	K562
CGGCGCGAAGAG	K562
TCGCATCGCTGC	GM
TTTTAATCCTCG	BJ
GATTGGCCTCTC	BJ
TTCTCGTGTCAA	H1
CTGACCTTGATG	H1
TATTATCATCCG	GM
GTTTATAACACG	H1
TGGCCTGGCGCG	GM
GAAAGTTTACCC	K562
GTCGAAAGCAGT	H1
TCGATGTCTGTA	BJ
AGCCGAAATCTC	BJ
CGGGTGCGTACT	GM
CGTTCGCGCCAA	K562
CTTTTCTATCTC	BJ
GAGAAGTGAGTA	H1
TAGCTTATACCG	K562
CTAACGCTCCCG	H1
TTAGAAATAGGG	BJ
ACACGTTCGGAT	GM
CCGTCCGATACG	K562
TTCCCTGTCCCG	K562
TTGCCGCGAAGC	H1
TACATTCTGCCC	BJ
TATCTACCTAAC	H1
TCGACTGCGATC	GM
TAGAACACATAC	H1
TGTTGATGGCAG	K562
CCCGTGTCCGCT	H1
AACTGTGCTAGT	K562
CAGAGATGTTAG	K562
GACGTTTAGATG	BJ
AGGAATTTACAC	K562
CGCGCCTCGGAA	GM
GATAGGTCGCAC	H1
AACCCTGGCGGA	H1
ACCATGGCCATC	GM
TTTGCTGACGAA	K562
CCTGGCAAGAGA	H1
TACTACCTCGTT	H1
AGCCGTGATGGT	BJ
AGTTTGGGCATT	BJ
ATCTTGACGGCG	K562
GTGGATGGTCTA	K562
TATTAGGACGCA	H1
GATTGTTGCAGG	K562
CAGTAAGTCAGT	GM
CGTGTGCAAAGA	K562
CCAGTAACCTTG	K562
ACCCGGGAACGA	H1
CGTACTTCGGAG	K562
AACCTCACTATA	BJ
AGGTCGACGCGT	H1
GCAGTCTCGGAC	H1
AAGTTGTTCGCG	BJ
CTTGTACAATCT	BJ
TCTGAAAGGGCG	K562
ATTCGCAATGCT	BJ
CGATTCAGCACT	BJ
GTTGAGACTATA	H1
TGTTTCGGAATT	H1
GAACACTTGCGT	H1
GGTTGCATCGTT	K562
CTAGAGGCTAGG	H1
ATATCCCCTCTT	H1
CCCACCTTATTT	GM
GACATGCGACTC	K562
CTCGTAAGCGGA	K562
GCATATCCCATC	H1
GACAATTTAATA	H1
GATGGTGAGACC	H1
CTCACACCATGC	K562
AAACGAACGATG	H1
CGGGCAGCGCTC	K562
GTATCATTTGCA	K562
CGCGGTTAAGAT	BJ
GCTCGGAGAATG	K562
GCATAGCACGAG	BJ
CTGTCAAATTCC	H1
TGTTGACTCTCT	BJ
TACCCCTGGGCC	H1
GGGCCGGGGTTC	BJ
GAATGCAGTGCG	K562
CAAAGATCAGTG	K562
CCCCTCAGAGCG	K562
TTGAGATTTTTT	BJ
TTGCGGTTTAGA	GM
CAGCTCGCTTAT	H1
GCAAGACGACCT	H1
TCATCCTCCACG	BJ
TCGCTGGCCTGG	H1
CCCAACCTCATA	H1
GTATACTGACGT	H1
CATAGTACATCA	K562
GTGCTTTTTTAA	H1
TCTGAGATGAGC	K562
GTCATTGTTGAA	K562
GTCGCATTCTGT	GM
CCCCATCGCGTG	BJ
ATCGCCACGGGC	H1
CTTAAGTTGAGT	GM
GTTCTGGTCCTG	H1
TATCCTATGCCT	K562
GCCTTATGGCGG	BJ
GCTTAAATGGCC	H1
AGGCACACCTCT	H1
GACGTTCAATCC	BJ
GCCTGAATCAAG	K562
CAACACCTAACA	K562
AAGACGGTCCTC	H1
ACAAGAGAATTG	H1
CAGTCCAATTGG	BJ
CTGTGTCACTAG	H1
TCTCGAGGGTAC	H1
CTTATGACTCGT	H1
GCTGAACTAACA	BJ
CACGCTTTACTG	H1
CAGGACATTTTA	K562
AAAACGCCTTTC	H1
TGCTACGTGTTC	BJ
CGGACAAGTTAA	H1
CCGCTTTACGTA	GM
GTCAATAACAAC	GM
CTCAACCCATTG	K562
CGCGGTTCTCCG	BJ
ATGCGATCTCTG	GM
GTCGCATTCATA	K562
CTATGTACCGGG	H1
GCCGTTGACGTA	H1
TCGACACGAAAT	BJ
CGACTCACTCGC	BJ
CACTTTCGGCAT	BJ
GATCCCTTGTGG	BJ
CGGTTTGCCCAG	K562
CTCGCCGCCCAT	BJ
ACTAAAGGCCTC	K562
GGCAACTGCTTA	BJ
GCGACACTGACA	GM
GGCAGCAATGTC	H1
AAGGCCCGCCAC	K562
GTAGGACCGCGT	BJ
ACCGTTTCTCTC	H1
TAAATAGTGTCG	H1
GACAGGAAATAT	H1
TCCAAATGGAAC	H1
CCCTTCCATTTC	BJ
ACTTCCCAAAAG	K562
AGACCGTCGTTT	H1
GAGATGGTATGA	BJ
GATTACGTTTGT	H1
ACCAACGATTCG	K562
GACCTCCGCTAA	K562
ACGTATTGCCTT	K562
GGGTATCCTCTA	GM
TATAACGCGGAT	K562
AACCGTTAGGTC	K562
ACGAAATGGTAT	K562
CATGGTCGCTTT	H1
GATAAAAGATGC	BJ
TTGACTGTCGAA	K562
CGAGCAACATTA	H1
TGTAGGGCTCAG	BJ
TTAGCGACTTGT	K562
CAGGGGGGAGGA	H1
GGAATTAAGTCG	K562
ACATCTAGGTAA	BJ
GCTCCAGACATC	BJ
GTCCTAGAACTG	H1
TAGGTCGGATAA	BJ
TGGTTACAACGA	BJ
AGTGTTAGCTTT	GM
CCTACACTCGGT	K562
AAAACCGGTACC	GM
GTGTGTCGGAGA	K562
GCCAGTCTGGCC	K562
ACAACGTGATCA	BJ
TAAAACAGTGCC	H1
CCAGCATACTCT	BJ
CCGCGATTATAG	H1
TAGAATTGCAGA	GM
ATGTAACTGGTG	K562
GGGTCGCCTTCT	H1
TAGGGCTCGGAC	H1
TTATGACAAGAA	BJ
ATGACTTACGCA	GM
GCACAACGGGTC	GM
ACCGCTAGCGGA	BJ
GCTACACCAGTG	GM
TACGCTTCCAGG	K562
TGCCTCGATGAG	GM
GGCGGCGACTCC	H1
TATCGCTGCTCC	BJ
ACAACCACCAAG	K562
TATGTCCCACGG	BJ
TGGGTTAGACGT	H1
GCGCATATAAGT	GM
GGGCTACAGCTG	H1
TGAGGTTACTCG	BJ
TTCGTATGTTCC	K562
TATTGTCTGTGC	BJ
CCTCTAATATCT	BJ
TGCACCGAGGCC	GM
TACACCACAGTC	K562
TCATTATCTACT	K562
TTGTACAGCACA	GM
TTCATTATCTGC	BJ
GGCGAATGCTAC	BJ
CATTGCGATCCT	K562
AACAGTTCCAAC	BJ
CAGGTAACCCGG	BJ
TACTGCCAGCAC	BJ
CCCGTTCGTATC	BJ
TTTACAACGTTG	H1
AGAATTAGAGTA	H1
AGCGGAAGGCCA	BJ
ATATCCCATCAT	GM
CTTACTCGTTCC	GM
AACCCCGGCCAG	H1
CGACGCCTACGA	BJ
TTTCACGACATT	K562
GAATCCTTATGC	H1
GCAAACCGCCTA	GM
AAGCTGGACGAT	BJ
TCGAGAGTTGAG	H1
AAGGGGCGACTC	BJ
GCCTTGCTGGTT	BJ
CTGCAAGACGTA	H1
CCAACCGTAGAT	K562
CGGTATCAGGAA	H1
GGACGAATCCCA	K562
CGACCATTCTCA	H1
GCGTCGTCCTAA	GM
CTCCAGAAATAG	BJ
TACGGTGAGTGT	K562
AAGCCTGTTGTA	BJ
GATGTAGGAGGA	BJ
ACCCTGGAGACG	K562
GTTTGGTGGTCG	BJ
GAGTCAACGGAA	K562
ACCTGGGGCAAC	H1
CGGATTGTTATT	K562
TGTTTACGCCTT	H1
AAGTTCCGAAAT	K562
CCGACGACCCTC	H1
GAGGGGCTCAAA	BJ
GTATTCCGATTA	BJ
TATCAAAGCGAG	H1
CACATGCAGCAC	H1
CTCACCTCTGAT	BJ
TCGGGGCTCATA	H1
CCCGAATCTATG	H1
CGGTACATTTGA	K562
ACTTGACTTGGC	K562
ATGGTCCGTAAG	GM
CAGCCAATGCCA	K562
CCAAGTGCCCTA	K562
GTCGACCAATTG	H1
CTGTCCGACCAT	GM
TGCCTTCTTTGA	H1
TGTAGATATTGA	BJ
AGGTAGCTTGGT	H1
TTGCCGGAGGGC	BJ
GTAGGCTGGAGT	K562
CGACTAGAACCA	BJ
GTGCCACACATT	H1
GACGACATGTTC	GM
GGCTGTACAACA	H1
AACGGGCCGCCA	BJ
AGACGAACCTAT	BJ
CGAAGTTTCGTA	H1
GTTGGGTAACAC	BJ
AACACAGGACAT	K562
AAGATTTAGGTA	H1
AGTTTTATACCT	K562
CAACAAGAGTAC	BJ
GGTTACCGTCTT	K562
TGAGTGAATGTT	GM
CTGTAGCCATCC	GM
GGATAGGGCCCC	H1
TGCACTTCACAT	K562
CGCGATACGGCG	H1
TGTGCCCGATAG	H1
GTCTAGAAGGGC	H1
CTCTACATCCTC	H1
TAGTGTCTGGCG	H1
CAACCCTGTGTC	H1
AGTTGGGCAGTC	K562
ATTAAGCAGAAC	BJ
CTTGCGACACTT	K562
TTCGCTGCGTTT	K562
GTTGAACCGATT	H1
TCCTTTTTTAGT	BJ
GCTAATGCCCAT	BJ
GGGCCAAACACC	GM
TCCCTGAGGTTT	GM
TAAGTGCGCTAC	BJ
TCGAACCGGTCA	BJ
AGTGAACCAGTG	H1
TAAACACGTAAG	K562
TATAGGCGAATA	GM
AAAATTCGATCA	H1
GGGAGACGAAGC	BJ
TGCATAGCTATC	H1
AACCTTTAGCCC	H1
ATCCCCCAGGGA	BJ
GTTCCGAACGGA	BJ
ATCTATATTGAA	H1
CGGAACTTCCCG	K562
CGTGTAACGTAG	H1
GCTGTTATGGGA	GM
TCGGGGATCACA	H1
ATTACTGCAGTC	GM
CTGCGACACTGG	H1
AAACCGCCATAT	H1
ACCTTGACATGG	H1
CTTATGACGGCG	K562
TCGCGAGGCGGT	BJ
AGTCAGGAACGT	GM
GCCAGCCACTTT	GM
AATTCACGTATG	H1
TTACACCGCTTG	H1
GAGTAACATAGG	H1
TTGATAAGGCTG	K562
AGCCGACGATGC	BJ
AGTGGTCTCCAA	H1
CATAAGCCAGCC	GM
TTACACCTGCAC	BJ
ACAAGCTAGGCG	H1
ACACTGAGCAGG	BJ
TCCACCTCACCT	BJ
CGGTAGAGCTAT	K562
ATTTGGCTACAA	GM
TCAGCTTCGGAC	BJ
CTTGCCGCCATT	GM
AAGCCCTAGACC	H1
ACAATTGCCTAC	BJ
CTTAGTCTGAGA	H1
AGGACGATTGTT	GM
GGGAGTTAAACC	H1
ACTTGTTAGTCT	GM
ATCGTTGGGCTG	BJ
ACGAACGCGCTT	BJ
CCAAATTACCGG	K562
CTTTTAGGTCGG	H1
ATCAGCTTGAAA	H1
ATAGTACCCTCC	GM
GCGTGGTTACGC	K562
GTAGTTCCGTTG	BJ
CGTCCTTAGATC	H1
GGAGTATAAACT	H1
GTAAATTACTGG	H1
TCGCAAGCACTC	GM
ATGTGAGGGTGG	K562
CCTTGTTCATTT	BJ
GTTGTCATTATC	GM
CAGAGCAACTTT	H1
CTCGTTCTGTAA	BJ
GTGGATGATCAC	H1
TGGGTAGTGCCG	K562
GATCTCCACAGG	GM
CGACCGACTTTC	BJ
GCTAACCTTATC	GM
GGTGCCTACAGT	K562
CGATTGTTAGCT	H1
GGCTGCCACACT	H1
TCGTCGGCACTT	BJ
CGAGATGTCGCA	K562
CTTGACAGTCTG	GM
GTAATATGATGC	GM
AGCACCGTATTT	BJ
ATCTGATACGTG	BJ
GGGACAATCCGT	K562
GGGTGCTCGGTT	BJ
AGTATACCTGAG	K562
ATTTGTTGAGCA	BJ
TTTTAACGAGAG	K562
CCACCGAGCAAA	BJ
GGCGGATACACG	BJ
AGCGTTGCGAGC	K562
CCCCAGCATAGG	BJ
AAACGAAAAGTC	K562
AGTGTTACCCTG	BJ
CCCGGCTTTTGG	H1
AGCCAATACCCT	H1
ATCGCGTGTATC	GM
CATGTCCCGGCC	BJ
CTGGTTAGTCAC	GM
CGGAGGAGGCTA	K562
GGATACGAAATA	BJ
CGAGCGGATAAG	K562
GGGCTATCTGAC	GM
TTCAGGGAGTTT	BJ
ATATTTTGCTAT	BJ
CACATCGCATCG	H1
CTGCACGCCCAT	GM
GTGAGCTAGAGA	K562
CTCAGTGAGATG	GM
CTTACCAGAGGT	K562
GGAGTGGGATGC	K562
TCTGAGTTAACC	H1
CATAAGGTCGTT	H1
GGTGTTTCCAGC	K562
GTGACTTCAAAT	H1
TTCCGTTTGAGT	H1
CCTGTGATAAGG	K562
CCTTCGCTGCCG	BJ
GGAGCTGTTAGA	BJ
CGCAGAGAAGCC	H1
GTCACTTGATCA	GM
TAACTTATGCCA	BJ
AAAGGGCCAAAG	H1
TTAGCTTTGTAT	GM
CTGCAGTAATAA	GM
ACACCCAATATT	H1
CGTATTCCAAGG	H1
ACGTTCCGAGAA	GM
CTACCCTTTGAA	GM
GAATCGTTAAGG	H1
GCCAACGAAATA	BJ
AATCTATGTCGC	GM
AGGATAAGTTAT	H1
TGTCAAGTTTAA	BJ
ACGCGCACCGGT	BJ
GGACTAATGCGT	GM
AAGGCTTGCTGC	GM
CGCTAAAATGCT	H1
ACACTCTGTTGC	H1
ATTGTTGACTAA	BJ
CCCCTCACAGTT	K562
TAAGCTCTTAAG	BJ
GTTCATGCTACG	K562
CGCTACGCTGTA	BJ
AGACCGCCATCA	GM
CGCTCGGGTGAG	K562
ATAATGGTTGTC	GM
CTACTGCCCCCA	GM
TTGCCGCGACAC	K562
GAAGAGCCATGC	H1
TTCGGGCTCTAC	GM
CTCAGGCTGTTC	GM
CGAAGCCAGGCA	GM
CGTGTTACGCAC	GM
GCCCTGACAACC	GM
CTCGCCCGATGT	K562
GCTCTAGCGCTG	GM
GAGTTGCGAGTG	GM
TTCCCTGGCGAG	K562
GCCGTCACGATC	GM
CCAGGGAGCCTT	GM
ATAGGTGACATA	H1
CCACCGATGCAT	H1
ATCGGCCTGGTT	BJ
CACGCATGCGCA	GM
CTTTGACGGGTA	GM
CGCCCCGAGATT	BJ
TCACATGACAGC	BJ
GACCTCGGGGTT	GM
ATTGCAAGCGCG	GM
CATGAAACTTGT	GM
GACGATATCCCG	GM
ATATCAGCCAGA	H1
CGGTCTCCGATG	H1
CGCGCGGGGCTG	H1
CTCTCAGGACTC	H1
TAGATGGTCCGG	K562
ACAATCCGTCTG	BJ
TCGCGAGGTGTC	H1
CTGGACGGGCGC	H1
CGCGCAACCGAA	BJ
GGTCATCAGACA	BJ
CCGATAAGAGCC	GM
TGAGAGTGGACT	GM
TTCGCGCTCGGA	GM
CGGTATGGGTGC	BJ
GAGTACTAGAGT	H1
TTAGGGCTTGGC	BJ
AGGAAGAAACCA	K562
GCAATCATAGTG	H1
ATAACCAAAAGA	K562
GAGTAATTCTGT	GM
CCACTCAACACC	GM
TGTAGCAGCTGC	BJ
GGAGTTACCGAG	H1
AGAAGTTAGACA	H1
GCGTTATTCTTG	GM
TCTAACTGCGAG	H1
GGCGTGGTCATG	H1
GGGTCAAAGCCA	BJ
CGGAACGAGTCA	H1
CGGGTGGGATCC	BJ
CTAGCACAAATC	BJ
GTCCTCCTCCGC	GM
TATTGTGGCTTT	BJ
TAGTCAGTCGTG	H1
ACGACCTCGAAC	GM
CAGACCCTGACA	H1
AGCTAAACATTT	H1
TTTTTTTGGTAG	BJ
GTCTTTCGGCCC	H1
GAGTTGGGGATG	H1
GTAATTGGTGGC	K562
TGTTCGTGACTG	H1
TGGAATCCGTAG	GM
GCCCGGGGCAAC	GM
GGGTCGATTGTT	BJ
TACTAACTTAAC	H1
AATTTGGGAGCA	K562
GACTTTCCGTAC	K562
GGCTTCCCTTCG	GM
GAGTGGGGCCCT	GM
CAGCCCCAAGGC	GM
CATATACATAAA	BJ
TACCGACAATAG	BJ
CACTGAAGGACC	H1
AGTGAAGATGGC	GM
CTTATCATAGTA	BJ
TTCGGTACAGTG	GM
TCCCTATTATCG	H1
CAGTGCACTTGC	BJ
GAATTGCCCGTA	H1
AATCCCACTAAT	H1
GGTAAGCGGTAC	H1
TGACTAAGAGTC	BJ
GAGGGCCCTATG	K562
GAAAGAACGAAG	H1
TCACCTTGCTAT	GM
ACGGCCTCCAAG	BJ
CGCGGTCGTCTC	BJ
ACCGTTGGGGCT	H1
GTTCTATTCCGG	H1
CGCTTCCGTAGC	H1
GAGAGTCGACAA	BJ
GGCGCGTGAGCA	GM
ACGGACAGTATT	GM
TCCCAACTCAAG	H1
CAGCGTCTGGTC	H1
GGTGAACGTCTC	H1
AATTTGTACATG	GM
CCGGCGTGCCCG	GM
GGGAGAACGATC	K562
TGTTCATAGGAC	GM
ATTAACACGGGG	H1
ATCGTTGACTTC	BJ
CAAAAAGCCCAC	BJ
ACGGACGATTCA	K562
ACGCAGGAAGCG	H1
GCGAGGCCCTGA	H1
CTTTTATAATGT	H1
TAGCCCGGTCCC	GM
TTCTAGCAGCCA	BJ
ACAGTTTAGAAA	H1
GTTCCGCCACTC	GM
AGTACCGATTGG	BJ
AGAAATACATTA	H1
GGCCGCCCGGGG	H1
TTCCCCTACAAC	H1
TGTAATCATCTG	H1
ACATAAATTAGT	BJ
ATAGTGCTCGCC	BJ
GTTCTTCCTAGT	H1
ATCCGTTCAACG	H1
CCGACTAAGAAT	K562
AAGCCTGGGGGC	H1
CAGCTGGTGATG	H1
